1.eliminate: Under the agreement, all trade barriers will be eliminate
2.Embrace: Some conservative people refuse to embrace new ideas and technologies and they adhere to old traditions and practices.

3.Encounter: Recently, There is a heated debate over whether we should offer assistance to those engaged in dangerous sports when they encounter life-threatening situation

4.Encourage: Females should be encourage to pursue their careers so that they can exhibit their versatile talents 

5.Endeavour: A responsible goverment should aways endeavour to help the disadvantaged to get rid of poverty/tackle poverty, conquer diseases and eliminate illiteracy.



6.Enforce: Strong anti-littering rules should be enforced effectively and backed by heavy punishment/hefty fines.



7.Engage: there is evidence that a growing number of females are engaged in violent crimes such as murder, kidnap and armed robbery.



8.Enhance: The adoption of shool uniform policies can promote capmus safety, improve discipline and enhance academic atmosphere.



9.Enjoy: Some old people like living in the nursing home because nursing home not only provides first-rate service but also creates opportunities for them to make new friends.



10.Although museums and galleries may not create commercial profits, they enrich people’s spiritual life.



11.Ensure: biodiversity must be preserved at all costs and measures should be taken to ensure more species from becoming extinct.





12.Escape: They managed to escape from the clutches of enemy soldiers



13.Establish: It has long been established that pets may give rise to the outbreak of epidemics.



14.Exert: a sedentary office life exerts an extremely bad influence on people’s health.



15.Expand: As tourism expands and reaches to remote corner of the earth, its impact on local culture is inevitable.



Page 28.



6.Experience: Facing the enormorous pressure of economy, society and politics, these tribes have to give up their own culture include language to embrace cul



7.Explore: In this essay, I intend to explore why teenagers take drug



8.Express: The government encourages artists to express themselves and create more artistic works for people of all ages.



9. Extend: Cloning technology can extend human life by creating human organs to replace those which fail to function.



10.Facilitate: modern technologies facilitate domestic chores.



11.Follow: Teenagers are immature and curious that they tend to follow blindly and emulate the behaviour of their idols.

12.Forbid: The law strictly forbids racial and sexual discrimination.

13.Force: Bad health forced her into taking early retirement.

14.Foster: Taking a part-time job can foster the awareness of competition and cooperation, which is quite necessary in one’s future career.

15.Fulfil: Job-hopping is still viewed as one of the keys to fulfil the higher goal in one’s professional path.

16.Gain: She gained high marks in English and Math.

17.Countries generate job oppotunities, increase tax revenue by tourism

18.The authorities could not guarantee the safety of UN observers

19.The writer handles the matter breifly and concisely

20.Smoking not only damage the smoker’s own health but also involve in people around them, making.





Page 40



3.Reject: Vegetarians reject traditional thinking of eating meat and advocate/promote the new eating habit.

4. Release: Proponents of euthanasia claim that it helps a patient to get rid of their suffering.



Page 41

5. relieve: Doing aerobics can relieve pressure which is why it is so popular among white-collar workers

6. remove: Urban citizens remove from city to countryside for wider space and fresher air.

7. Teenagers are so immature and tend to follow blindly/sequacious, so it is difficult for them to resist the temptation of the advertisment to them./that they can hardly resist the temptation of the advertisements targeted at them.



8.It is our duty/obligation to respect and support our aged parents

9.safeguard: censorship can ensure that certain minimum standards are maintained, for example, children’s programming and serious current affairs coverage are safeguarded

10.Satisfy: Museums and galleries satisfy the people’s needs of high-level spiritual life. 

11.Share: The problem of e-book is whether it can replace the intimate relationship between the traditional books and readers

12.Shoulder: Museums shoulder the responsibility to preserve and advocate/carry forward our national culture.



Page 44.

13.Stimulate: A good balance of two sexes can stimulate students’ zest/passion for study in an rather unbelievable/miraculous way.

14.Increased public investment in the arts strengthen our country’s competitive edge in the areas of education, tourism, economic development and community revitalization.

15.Struggle: we don’t have to struggle through traffic in the morning and afternoon if we choose telecommuting.

16.Smoking is harmful to our health, smokers are more likely to suffer from bronchitis and lung cancer and have a high risk of developing other kinds of cancers.

17.Undermine: family bonding is a massively important element of a child’s development, which is constantly undermined in modern society.

18.Ability grouping violates the students’ right to receive education of same quality 

19.Contact with tourisms from all over the world widen the vision of local residents.

20.Withdraw: As many as half the drugs that have been approved in the US and the UK after animal testing have subsequently had to be withdrawn because of harmful side effects.





Page 45

1.Abolishment: The abolishment of superstitious pratices and customs should be carried out as soon as possible since they may poison people’s mind

2.Absorption: As for proponents of meat eating, absorption of nourishment is the major reason for them to have meat.

3.The abundance of historical and cultural books in libraries enables citizens to have an understanding of their coutries’ past.

4.Abuse: Abuse of performance-enhancing drugs is not uncommon among athletes.

It’s not uncommon for athletes to abuse performance-enhancing drugs.

5.Access:  Citizens should have free access to the library so that they may get contact with the latest information

Page 47.

6.Accomplishment: School uniforms increase attendance and academic achievement, so the practice of wearing uniforms at school should be popularised.

7.Adaptability: Deforestation will drive animals without adaptability to new surrounding into mass extinction.

8.Advancement: The lack of daily contact with coworkers could take us ‘out of the loop’ relative to what is going on within the company. This lack of ‘inside knowledge’ could affect our advancement with the company.

9.Advent: The discussion on whether the human race can go against nature by cloning themselves has heated up with the advent of the first cloned sheep Dolly.

10.Aid: Positive relationships with pets can be an aid in the development of trusting relationships with others.

11.Ailment: Meat and dairy centred diets are linked to many types of cancers, as well as heart diseases, diabetes, obesity, gallbladder diseases, hypertension, and more deadly diseases and physiological disorders.

12.Assessment: It is hard to make assessment on the necessity of drug legalisation if merits and demerits of the practice are not fully discussed.

13.Atmosphere: This old building has a lot of/ is full of atmosphere.

14.Authority: Health authorities should take proper measures to deal with the increasingly serious rubbish problem in urban areas.

16.Ban: The president supports a global ban on nuclear testing.

17.Breakdown: Tension human relationship, heavy pressure from work and life and fierce competition contribute to many whiter-collar workers’ nervous breakdown.

18.Breakthrough: Based on wireless technology, developed countries have realised the breakthrough of providing long distance education for children in remote areas.

19.It would be a calamity for the farmers if the crops failed again

20.Campaign: A growing/increasing number of people in China enter upon the campaign of saving rare animals out of extinction.



Unit2

1.Captivity: Keeping animals in captivity goes against animal rights.

2.Career: She realised that her acting career was over.

3.The oil spill threaten an unparalleled ecological catastrophe.



Page 51

4.Celebrity: Paparazzi pursue celebrities because the public have strong interests in the famous people’s private life.

5.Censorship: censorship should be imposed on the Internet so that children will not be exposed to violence and pornography.

6.Challenge: telecommuting raises a challenge to the old style of working in office.

7.Characteristic: E-books have characteristics that in some ways supersede those of traditional books, being more flexible and accessible than paper books will ever be.

8.The habit of eating meat excessively hinders blood circulation because fat contained in the diet may clog blood vessels.

9.Cohesion: Olympic Games has played a indispensable role in increasing a nation’s cohension.

10.Communication: A good relationship with a pet can also help in developing non-verbal communication, compassion and empathy.

11.Compensation: Equal compensation should be given to men and women for equal work.

12.Computer: As a telecommuter, you may have extra expenses, such as the purchase of equipment, special insurance to cover household items for business use.

13.Conservation: Conservation of creatures and plants equals maintenance of our ecosystem.



Page 53

14.Consumption: A good point of e-books is the fact that they can help reduce consumption of timber consumption.

15.Contempt: The one who escapses from military service has always been treated with contempt.

16.Corruption: The chief executive is being investigated for alleged corruption.

17.Due to globalisation, suits have replaced various national costumes as man’s proper dresses in formal occasions.



Page 54

18.Coverage: People may feel safe and protected if they are aware that they are within the coverage of surveillance cameras.

19.Creativity: Companies are often keen to sponsor the arts as it gives them an opportunity to associate their bands with creativity, generosity and excellence.

20.Crisis: Ecosystem failure resulted from deforestation, overexploitation and pollution causes various crises including African food one.



Unit 3

1.Critic: The critics of globalisation say we have lost sovereignty and the world economy are controlled by big international corporations and foreign exchange traders.





Page 55

2.Cultivation: Parents should supervise their children’s spending of pocket money for the purpose of cultivation of good financial habits.

3.Curiosity: Curiosity is the nature of human beings.

4.Deception: The white lie is a kind of deception despite that they are told out of goodwill.

5.Delinquency: Many theories concerning the causes of juvenile delinquency focus either on the individual or on society as the major contributing influence.

6.Depression: She was overcome by depression. (be overcome by:被什么困扰)

7.Destiny: Our intelligence is determined at birth genetically but our destiny can be changed with our efforts

8.Destruction: Destruction of forests and natural vegetation leads to soil erosion.

9.Deterioration: Zoos are suitable habitats for some species which are on the verge of extinction due to environmental deterioration(are on the verge of 即将)

10.Dignity: Patients who choose euthanasia wish for not losing their dignity of life when they die.

11.Dilemma: Females often find themselves in a dilemma whether they stay home to be full-time housewives or go out to pursuit their own careers.

12.Disaster: One hundred and eight people died in the mining disaster.

13.Discrimination: Discrimination agains women is considered an out-of-date idea that violates the equality principle.

14.Disposal: The growing number of computers and electronic devices has begun to create a disposal problem.

15.Dispute: Allocation of international aids is a hotbed of political dispute.

16.Distinction: The distinction between smart children and retarded children has the nature of discrimination.

17.Distribution: The problem of unfair employment distribution results from social convention instead of competence or true abilities.

18.Diversity: Just because of the diversity of abilities, the children can gain/obtain much more knowledge and novel thoughts from their peers.

19.Drug: Proponents of school uniforms believe that requiring students to wear uniforms can help reduce assaults, thefts, vandalism, and weapon and drug use in schools.

20.Ecology: Natural ecology will suffer a destructive blow if man does not stop producing pollution.





Page 58 (Unit 4)

1.Elimination: Schooling children from home means elimination of their chances to play with their peers.

2.Elite: Only a small elite among mountaineers can climb these routes.

3.Embarrassment: In the single-sex environment, boys do not feel any embarrassment in showing an interest in those ‘non-macho’ activities.

4.Enforcement: Strict enforcement of laws and regulations helps reduce traffic accidents.

5.Entertainment: Statues in urban areas provide citizens with cultural and spiritual entertainment. Provide cultural and spiritual entertainment to citizens

6.Enthusiasm: The play aroused his enthusiasm.

7.Environment: Children fail to adjust themselves to the new environment abroad because they are too small to do so.

8.Equality: Even employed women did not achieve full equality with men.

9.Evaluation: Students’ evaluation of teachers’ performance helps to improve teaching quality.

10.Evil: Violence and crimes shown on TV or movies are reflections of social evils in real life.

11.Exchange: TV/television occupies most of people’s leisure time. In this sense, it interferes the exchanges of feelings among people.

12.Extinction: Cloning technology can be used to increase the population of endangered species of animals and thus save them from extinction.

13.Feeling: The Children who are addicted to the Internet lack adequate exchanges of feelings with their parents.



Page 62

14.Flavour: Travelling enables tourists to taste foods and cultures of different flavours.

15.Flexibility: Although telecommuting/working at home is undoubtedly more flexible(provide more flexibility), it also provide a fair bit more stress.

16.Freedom: You have the freedom of my garden.

17.Genius: Some children are not suitable for normal schooling, which will kill/stifle their genius/talent.

18.Gratitude: Please allow me to express my hearty gratitude to you for your support to my work in London.



Page 63

19.Greed: Man is really cruel to kill animals just for obtaining their fur, skin, horns, teeth and meat to satisfy his greed.

20.Guidance: Without proper guidance, students are prone to lose their ethical values when they take part-time jobs in society.



Unit 5

1.Harmony: Your suggestions/advices are not harmony with the aims of this project.

2.Heritage: Language is a nation’s indispensable cultural heritage as well as the common heritage of mankind.

3.Horizon: TV programme can broaden their horizon and enrich their life experiences.

4.Household: It can be difficult to motivate youself when you’re working from home. There are household chores to be done and plenty of other distractions.

5.Hygiene: One major concern of hygiene in urban areas is to dispose of rubbish in time.

6.Ignorance: The main reason of youth drug abuse is ignorance and curiosity.

7.Imitation: Man has got lots of inspirations from animals. For example, imitation of flying birds resulted in the invention of aeroplanes.

8.Indifference: Some pet-lovers show love on animals but indifference on people.

9.Individuality: Individuality is the salt of common life.

10.Infrastructure: To some extent, the travelling industry promotes a city’s infrastructure because tourists ask for better transportation and accommadation condition.

11.Infringement: The Senate rejects the principle of federal control as an infringenment of state’s rights.

12.Innovation: Companies are able to tell the public about any legal product through advertisment. Or innovation will be restricted and new companies will find it hard to market their products successfully in the face of established rivals

13.Insight: Part-time job experience give students an insight into what work is about and prepares them psychologically for their future career.

14.Inspiration: Wildlife give man many inspirations and improve the quality of human life.

15.Instinct: Some women depend too little on reasoning and too much on intuition and instinct to arrive at right decisions. 

16.Intake: High cholesterol or high intake of fat can be extremely harmful, leading to heart diseases, obesity and other diseases.



Page 67

17.Integrity: Regular job-hoppers’ integrity and loyalty may be questioned.

18.Face-to-face interaction in shool is an important aspect of student social development.

19.Interference: To some countries, foreign aid is an interference of their internal affairs.

20.Intervention: Extinction is a natural step of evolution. Any outside intervention will be wasted effort.



Unit 6

1.Jeopardy: The killings could put the whole peace process in jeopardy.

2.Lack: Vegetarians are usually found to have a lack of necessary proteins since vegetarian diet consist mainly of plants.

3.Leisure: The majority of adults never visit a museum, preferring instead leisure pursuits such as football, the cinema or clubbing.

4.Liberty: The constitution guards the liberty of the people.

5.Minority: Although minority people are fully aware of the loss of their languages, there is not much they can do.

6.Monopoly: A university education shouldn’t be the monopoly of the minority whose parents are rich.

7.Motivation: Gun carriers with bad motivation create/pose potential threat to the whole society.

8.Nutrition: Only a balanced diet, no matter whether it is a vegetarian or meat-eating, could provide your body with nutrition.(营养,  nourishment:食物,滋养品)

9.Obesity: Children’s obesity has been an increasingly serious health problem through the world.

10.Obligation: By serving in the army, a citizen fulfils his duty and obligations to maintain the stability and unity of the country.

11.Obstacle: Fear of change is the greatest single obstacle to progress



Page 70

12.Opponent: Opponents claim that pocket money encourages children to follow incorrect ways of consumption and exerts an adverse impact on the healthy development of the young generation.

13.Participation: Commentators in zoos often encourage children’s participation into animal protection, which contributes to cultivation of future environmentalists.

14.Peer: Children need to share their happiness and sorrow with their peers, but schooling at home deprive them of the opportunity(but home schooling kills their chance to do so, but they are deprived of opportunity by home school to do so). 

15.Penalty: The penalty for murder is death(capital punishment)

16.Peril: In order to obtain/get valuable data, researchers ignore animals’ peril in experiments.



Page 71:

17.Perspective: Before presenting my view, I intend to discuss this hot issue from diverse perspectives.

18.Pollution: The nation is becoming to understand the value of pollution prevention.

19.Popularisation: With the popularisation of cars, the suburbs will become more developed, and the downtown area will be less crowded.

20.Population: Cloning technology could be used to increase the population of endangered species of animals and thus save them from total extinction.



Page 72(Unit 7)

1.Potential: Competition stimulates athletes’ potential, making them combative.

2.Poverty: China is a developing country and many people are still living below the poverty line.

3.Preference: Distinctive differences in physical strength, resistance and personality exist between men and women, which decides different preferences in subjects/majors.

4.Prejudice: Since tourism helps people to promote interactive understanding, it will finally wipe out prejudice against other nations, and make the world a more peaceful one.

5.Preservation: The breakthrough of cloning technology could mean the preservation, through DNA extraction, of all endangered species.

6.Priority: The government and the public have given increasingly high priority to the problem of children’s education.

7.Privilege: The privilege of holding the Olympic Games has long been a source of national and civic pride, with the opportunity to showcase a country and especially th e host city.

8.Prohibition: The alcohol prohibition should be implemented by law, which is more powerful/reliable than moral consciousness. 

9.Promotion: Telecommuters may have to fear being forgotten or overlooked for choices of assignments, training opportunities or promotions.

10.Property: More rigid laws and regulations should be laid down to safeguard the safe and property of the public

11.Proponents of PE believe that it is a crucial element of all-round education and our society’s wellbeing.

12.There are good prospects for growth in the retail sector.

13.Pursuit: People target at lofty spiritual pursuit after they satisfy the basic demands for survival.



Page 75

14.Replacement: Replacement of failed organs with cloned ones is considered a possible method to extend man’s life.

15.Reputation: This restaurant has a very good reputation.

16.Reservation: He is willing to agree to the proposal with one reservation.

17.Resource: educational resources cannot be wasted, so computers instead of teachers should deal with tedious and repetitive tasks.

18.Restriction: Some people believe that it’s restriction of student’s freedom to required student to wear school uniforms(Requiring students to wear uniforms is regarded as the restrictions on students’ personal freedom)

19.Sacrifice: Minorities merge into the mainstream culture at the sacrifice of losing their unique cultural identities.

20.Safety: No one’s safety can be guranteed without gun control.



Unit 8

1.Sanitation: Environmental sanitation has been paid much attention to since serious environmental pollution threatens people’s life.

2.Scandal: Some newspapers thrive on spreading gossip and scandal.

3.Scope: Animal experiments are necessary in view of their medical value, but they should be carried out within the scope of tolerableness

4.Military life cultivates the strong feel of responsibilities in young people.

5.Shortage: Increasingly companies are turning to new and varied employment strategies in response to skills/technology shortage, reduced property costs, high overheads and changing employee expectations.

6.Source: Money is the source of all evils, so parents should be careful when they give pocket money to their kids.

7.Species: This type of rattle snake has been declared an endangered species.



Page 78

8.Stability: By serving in the army, a citizen fulfils his duty and obligations to maintain stability and unity of the country.

9.Statistic: Statistics show that the poorer a coutry is, the worse corruption exists there.

10.Stereotype: Artists should break through the stereotype of high-hearted men who look down upon money if they seek for financial support from the government.

11.Stimulation: Pocket money may serve as proper stimulation to children if parents use it as an award to kids’ good academic performance.

12.Strain: People are confronted with the strain of modern life. They need some relaxation.



Page 79

13.Strategy: Children naturally tend towards behaviour appropriate to their gender. It is therefore easier to implement an education strategy geared specifically towards one gender.

14.Strength: The government should use all of its strength to preserve historic buildings which, once destroyed, will never be restored

15.Stress: Modern people should learn how to cope with various forms of stress or they cannot continue their normal work or study.

16.Subsistence: Not even subsistence is possible in such conditions.

17.Substitute: Parental instructions and suggestions offered at home are not equal substitute of education at school.

18.Superiority: Compared to the elderly, the young generation have their superiority: creative ideas, fresh mind in management and technology and endless energy in their work.

19.Superstition: Information that encourages racialism, violence, superstition and terrorism threatens social security. It should be baned by the government with a view to purify the social environment.

20.Supervision: Parents are able to provide contant supervision for their children at home while teachers fail to do so.



Unit 9

1.Supplement: Many vegetarians have to take vitamin and mineral supplements to make up for the lack of iron, B12 etc. In their diet.



Page 81

2.Surveillance: Many stores and families install surveillance cameras but many people go against the practice.

3.Survival: Our disregard for the environment threatens the long-term survival of the planet.

4.Symbol: The dove is a symbol of peace.

5.Symptom: symptom of too much pressure include insomnia, amnesia, unexplainable headache and sudden depression.

6.Talent: The Olympic Games provides a stage for sports talents to bring their potential into full play.

7.Temptation: There might be a temptation to cheat if students sit too close together.

8.Tendency: We should put right the tendency of stressing only students’ academic achievement and ignoring their moral and physical education.

9.Theory: Education is but a failure if it only produces people who are unable to put theory into practice.

10.Therapy: Euthanasia is the last resort that cancer patients turn to for pain relief after failure of all therapies.

11.Threat: These people pose/present a true threat to the community.

12.Tolerance: Compared to the elderly, many youngster have a very limited tolerance to others.

13.Torture: Hearing her practice the violin is torture.

14.Traffic: Salary, traffic, status and promotion opportunities are major concerns of job-hoppers.

15.Transfer: The transfer of human genes into animals and vice versa heightens the danger of developing zoonoses, diseases that are transmitted from animals to humans.

16.Trait: The military life cultivates a valuable character/personality traits. Young people are taught respect for authority, self-discipline, cooperation/teamwork and leadership skills.

17.Tragedy: The end of the international aid to poor countries will cause/lead to a tragedy that more thousands of poor people in these countries die of starvation or lack of medicine. 

18.Transformation: Changes in people’s attitude towards marriage and family have originated from social transformations.

19.Treasure: Traditional customs have undergone thousands of yeas of practice and become the treasure of a nation.

20.Approval of Kyoto Protocol on global warming is a great triumph of the environmental protection campaign.



Unit 10

1.Upgrade: Even university education is not the terminal of person’s study life. The view is quite true/right/correct in the current society which demands constant update of knowledge.

2.Urbanisation: Many skyscrapers have been built around zoos due to urbanisation, Zoos and animals have lost the good environment for survival and space for development.

3.Urge: It is natural that young people/youngsters/adolescents/youth feel the urge to be attractive to the opposite sex.

4.Value: The value of language to a people cannot be measured by money or any tangible assets.

5.Variety: Modern society provides a variety of employment opportunities, freeing people from the situation that they have to stay in one company for a lifetime.

6.Vegetation: Livestock production is a major cause of desertification where the land dries out and loses its precious topsoil so vegetation is unable to grow on it anymore.

7.Victim: Vital public services have fallen victim to budget cuts.

8.Vigour: Compared to the elderly, young people are full of vigour but fail in carefulness.

9.Violation: The doctors and nurses involved in euthanasia have discredited their profession, for euthanasia is a violation of the fundamental medicine principle to save human life.

10.Violence: Violence in movies gives audience the false feeling that any problem could be solved by force 



Page 87

11.Virtue: Children should develop the habit of working and living independently and, meanwhile, practise the virtue of being filial to their parents.

12.Vision: Everyone has a vision of himself/herself as a celebrity because the latter has fortune, reputation and everything else that ordinary people dream of having.

13.Vitality: He’s a person of great vitality.

14.Warning: An effective warning can be printed on every packet of cigarettes that is to be sold, to scare smokers out of sucking those sticks.

15.Waste: Don’t let all this food go to waste.

16.Weakness: Competition means that you should make use of the weakness of your opponents to defeat them. So this is a cruel game. 

17.Welfare: It is the governments’ obligation to seek the people’s welfare.

18.Wisdom: The elderly have wisdom while the young people have vigour/vitality.

19.Worship: Entertainment stars can be lose their fans’ worship because of scandal and gossip.

20.The majority of women have a yearning to realize/for realizing their own value in society.





形容词和副词400

Page 89

1.Abandoned: It is easy for telecommuters to have a feeling of being abandoned by their employers.

2.Abnormal: Animals kept in the zoos suffer from psychological distress/depression, and often displayed by abnormal and self-destructive behaviour

3.Aboriginal: Many aboriginal languages and cultures are on the verge of extinction.

4.Abrupt: Abrupt catastrophes may come one day if mankind continues to pollute the environment.

5.Absorbing: Some TV shows are so absorbing that few teenagers could resist their temptation

6.Absurb: It is an absurb idea that number 13 brings bad luck.(The idea that the number 13 brings bad luck is absurb)

7.Abundant: Citizens enjoy a great number of advantages including abundant employment opportunities, fine public facilities, high-level education and good living environment.

8.Academic: She love this city due to it’s good academic atmosphere.

9.Accessible: E-books have characteristics that in some ways are superior to those of traditional books, being more accessible and flexible than paper books will ever be.

10.Accountable: The government is accountable to the public for its protection of cultural heritage.



11.Adaptable: The co-educational system makes children more social adaptable.

12.Addicted: Some people may be addicted to computer games/net surfing, which is harmful to their health/impairs their physical and mental health.

13.Admirable: This project is admirable for the vast labour it involved.

14.Adolescent: Many psychological and physiological problems vexing an adolescent student can be readily solved in a co-educational school. 


20.Astray: The temptations of the big city soon led him astray.



Unit 3

1.Astronomical: Astronomical sums of money will needed for space exploration.

2.Athletic: The Olympic Games are the world’s largest pageant of athletic skills and competitive spirit.

3.Authentic: Museums and galleries have an abundance of authentic paintings and works of art.

4.Available: The university is trying to make more accommodation available for students.

5.Awkward: whether doctors should tell white lies to cancer patients or not remains an awkward question.

6.Backward: Due to backward science and techonology, People in developing countries and regions such as those in Africa, Latin America and Asia are suffering  a great deal from poverty, hunger and lack of water resource.

7.Balanced: As animals dependant on natural world for survival, we are justified in choosing food that gives us a balanced diet.(be justified in doing sth 理所应当的做某事)

8.Baneful: Waste gas emitted by cars has exerted a baneful influence on natural environment(exert considerable/a influence on sb)

9.Barbaric: As the saying goes, “Seeing is believing”. Only a trip to an unfamilar land can help us understand that the people and culture there are not as barbaric as we think.

10.Barren: It is useless to continue such a barren argument.

11.Beforehand: If we had known beforehand that cars manufacturing would cause such a disaster to our environment, we might have given up the industry.(such 修饰名词, so 修饰动词)

12.Benefical: Raising pets is beneficial and joyful

13.Benign: Co-education encourages benign competition and cooperation between male and female students.

14.Bewildering: Space exploration is at the same time a bewildering and exciting topic.

15.Biased: I admit I am biased, but I think our performance was brilliant.

16.Bilingual: Overseas education provides students an opportunity to be familar with anther culture and become bilingual ones.

17.Biologial: This biological laboratory undertakes the highest level of creative research and education in biology.

18.Booming: The image of a country as a modern, civilised and dynamic society can be enhanced booming cultural development.

19.Boundless: The Internet occupies little space and has a boundless storing capacity.

20.Brutal: Nothing can be more brutal than taking away human life.



Unit 4

1.
